㖈	䎛
㘽	㦳
㦳	㘽
㫚	曶
䆋	龝
䎛	㖈
丄	上
丅	下
上	丄
下	丅
丌	其
不	不
世	丗
丗	世
丘	丠
両	兩
丣	酉
並	幷
丬	爿
丱	卝
串	串
丹	丹
为	為
乃	廼
久	乆
乆	久
乇	虐
乕	虎
乗	乘
乘	乗
乩	稽
亀	龜
亁	乾
了	了
予	豫
亊	事
事	亊
二	贰
于	扵
亓	其
五	伍
亗	歲
亘	亙
亜	亞
亝	齊
亞	亜
亡	亾
产	產
京	亰
亮	亮
亯	享
亰	京
亱	夜
亷	廉
什	什
仁	忈
仂	働
仃	停
仇	讐
仏	佛
仙	僊
仝	同
仞	仭
仟	千
令	令
仭	仞
仮	假
任	仼
仼	任
份	彬
仿	倣
伍	五
伙	夥
伜	倅
伝	傳
伩	信
伲	你
佈	布
佔	占
佛	仏
佞	侫
你	妳
佰	百
併	倂
侄	姪
來	來
侉	誇
価	價
侫	佞
侭	儘
便	便
俊	儁
俎	爼
俞	兪
俟	竢
信	伩
俥	伡
俱	倶
俲	效
俻	備
倂	併
倅	伜
倖	幸
借	藉
倣	仿
値	值
倫	倫
倶	俱
倹	儉
值	値
假	仮
停	仃
偷	偸
偸	偷
偹	備
偽	僞
傢	家
傤	儎
僊	仙
働	仂
像	象
僚	僚
僞	偽
僣	僭
僥	徺
僭	僣
儁	俊
儌	僥
儎	傤
兀	兀
兇	凶
光	灮
兎	兔
児	兒
兔	兎
兦	亡
兩	両
六	六
其	丌
兿	藝
円	圓
冐	冒
冑	胄
冗	宂
冝	宜
冢	塚
冤	寃
冦	寇
冨	富
冪	羃
冬	鼕
冰	氷
冱	沍
冲	沖
冷	冷
冽	洌
净	淨
凃	塗
凄	淒
凅	涸
凋	雕
凌	凌
凖	準
凡	凢
凢	凡
凣	凡
処	處
凨	風
凴	憑
凶	兇
凷	塊
出	岀
凼	幽
函	凾
凾	函
刀	刂
刂	刀
刃	刄
刄	刃
切	切
刈	苅
刊	刋
刋	刊
刔	抉
列	列
刦	劫
利	利
刱	剏
刴	剁
刺	刾
刼	劫
刾	刺
剁	刴
剏	刱
剙	創
剣	劍
剤	劑
剩	剰
剰	剩
剱	劍
剳	箚
創	剙
剷	鏟
剿	勦
劆	鐮
劑	剤
劔	劍
力	力
劢	勵
劣	劣
劫	刦
労	勞
劵	券
効	效
勃	艴
勒	勒
勛	勲
勞	勞
勤	懃
勦	剿
勧	勸
勲	勛
勳	勛
勵	劢
勸	勧
勾	句
北	北
匳	奩
匹	疋
匿	匿
十	拾
千	仟
卄	廿
卆	卒
升	昇
卋	世
卍	卐
卐	卍
卒	卆
協	恊
単	單
博	愽
占	佔
卩	部
卮	巵
卯	戼
即	卽
卵	卵
卷	捲
卸	缷
卹	恤
卽	即
厄	阨
历	歷
厐	龐
厕	廁
厖	龐
厛	廳
厠	廁
厰	廠
厳	嚴
厵	源
厶	私
叁	參
參	參
叄	參
叆	靉
叇	靆
収	收
发	發
叜	叟
叝	告
叟	叜
叡	睿
句	句
只	止
吁	籲
吃	喫
合	閤
同	仝
吏	吏
向	嚮
吝	吝
吞	呑
启	啓
吳	呉
吿	告
呂	呂
呆	騃
呉	吳
告	吿
呑	吞
呪	咒
呱	哌
呵	訶
呼	謼
咀	嘴
和	龢
咒	呪
咨	谘
咬	齩
咯	詻
咲	笑
咽	咽
哄	閧
哌	呱
唇	脣
唉	誒
唖	啞
唧	喞
唷	唹
啓	啟
啔	啓
啖	啗
啗	啖
啞	唖
啯	嘓
啰	囉
喃	嫐
善	譱
喇	喇
喞	唧
喧	吅
喩	喻
喫	吃
單	単
喰	餐
営	營
喻	喩
嗀	嗀
嗬	呵
嘎	尜
嘑	呼
嘓	啯
嘨	嘯
嘩	譁
嘯	嘨
嘴	咀
噁	恶
噅	噕
噐	器
噕	噅
器	噐
噪	譟
嚏	嚔
嚔	嚏
嚙	齧
嚠	瀏
嚢	囊
嚥	咽
嚴	厳
嚻	囂
囉	啰
囊	嚢
囌	蘇
囓	嚙
囘	回
回	囬
団	團
囯	國
囲	圍
図	圖
囹	囹
圀	國
圈	圏
國	圀
圍	囲
圎	圓
圏	圈
圓	圎
圖	図
團	団
圧	壓
圻	垠
址	阯
坐	座
坑	阬
坛	壇
坫	店
坯	壞
垂	埀
垓	陔
垛	垜
垠	圻
垩	聖
垻	壩
埀	垂
埒	埓
埜	野
埼	崎
堇	菫
堊	聖
堦	階
場	塲
堺	界
塆	壪
塈	墍
塊	凷
塔	墖
塗	凃
塚	塚
塜	塳
塞	塞
塟	葬
塡	填
塩	鹽
填	塡
塳	塜
墍	塈
墖	塔
増	增
墙	牆
墫	樽
墻	牆
壊	壞
壌	壤
壓	圧
壘	塁
壞	壊
壟	壟
壤	壌
壪	塆
売	賣
壳	殼
壷	壺
壹	搋
壺	壷
夀	壽
夊	攵
复	復
夐	敻
夘	卯
多	夛
夛	多
夜	亱
夥	伙
夭	殀
奇	竒
奈	柰
奌	點
契	契
奔	犇
奖	奬
奘	弉
奨	奬
奩	匳
女	女
奶	嬭
妊	姙
妍	姸
妒	妬
妙	玅
妫	媯
妬	妒
妳	你
姉	姊
姊	姉
姜	薑
姢	娟
姪	侄
姫	姬
姬	姫
姸	妍
姻	婣
娘	孃
娚	喃
娟	姢
娯	娛
娿	婀
婀	娿
婣	姻
婬	淫
婾	媮
婿	聟
媯	嬀
媿	愧
嫋	嬝
嫐	喃
嫺	嫻
嬀	媯
嬝	裊
嬢	娘
嬾	懶
孃	娘
孚	孵
孳	孶
孵	孚
孶	孳
孼	孽
孽	孼
宂	冗
它	牠
宅	宅
宍	肉
宜	冝
実	實
家	傢
宻	密
寃	冤
密	宻
富	冨
寓	庽
寕	寧
寘	置
寛	寬
寜	寧
察	詧
實	実
寬	寛
寮	寮
寳	寶
専	專
尅	剋
尒	爾
尓	爾
尙	尚
尚	尙
尜	嘎
尠	鮮
尥	尦
尦	尥
尨	龍
尪	尫
尫	尪
尭	堯
尽	盡
尿	尿
屏	摒
屛	摒
屢	屢
履	履
屩	蹺
屭	屓
岐	歧
岗	岡
岩	巖
岫	峀
岭	岺
岳	嶽
岺	岭
岽	崠
峀	岫
峨	峩
峩	峨
峯	峰
島	嶋
峺	硬
崈	崇
崋	華
崎	埼
崐	崑
崑	崐
崕	崖
崗	岡
崘	崙
崙	崙
崟	嶔
崠	岽
嵆	嵇
嵐	嵐
嵜	崎
嵯	嵳
嵳	嵯
嶋	島
嶌	島
嶔	崟
嶺	嶺
嶽	岳
巌	巖
巔	巓
巖	巌
巡	廵
巢	巣
巣	巢
巨	鉅
巴	笆
巵	卮
巺	巽
巻	捲
巽	巺
布	佈
帋	紙
希	稀
帚	菷
帡	帲
帬	裙
席	蓆
帯	帶
帰	歸
帲	帡
帳	賬
帶	帯
幇	幫
幚	幫
幢	橦
幤	幣
幱	襴
干	乾
年	秊
并	並
幷	並
幸	倖
幽	凼
庁	廳
広	廣
庅	麼
床	牀
店	坫
度	廓
座	坐
庵	菴
庶	庻
庻	庶
庼	廎
庽	寓
庿	廟
廃	廢
廄	廐
廉	廉
廊	廊
廏	廄
廐	廄
廓	廓
廠	厰
廢	廃
廩	稟
廪	稟
廬	廬
廰	廳
廳	廰
廵	巡
廸	迪
廻	回
廼	乃
廽	回
廾	廿
廿	廾
弁	辨
弄	弄
弉	奘
弌	搋
弍	二
弦	絃
弾	彈
彂	發
彊	强
彐	彑
彑	彐
当	當
录	錄
彗	篲
彙	彚
彚	彙
彛	彝
彜	彝
彝	彛
彨	彲
彬	份
彲	彨
彷	仿
彿	髴
往	徃
徃	往
律	律
従	從
從	従
徠	來
徧	遍
徨	遑
復	覆
徳	德
徴	徵
德	惪
徺	僥
忈	仁
志	誌
応	應
忞	暋
忰	悴
念	念
忻	欣
怒	怒
恂	悛
恊	協
恤	賉
恵	惠
恿	慂
悋	吝
悛	恂
悤	匆
悪	惡
悫	慤
悳	德
悴	忰
悽	淒
惠	恵
惡	惡
惪	德
惷	蠢
愈	癒
愧	媿
愨	慤
愬	訴
愼	眘
愽	博
慂	恿
慄	慄
慎	愼
慙	慚
慤	愨
慭	憖
慽	慼
慾	欲
憅	慟
憇	憩
憐	憐
憑	凴
憖	慭
憩	憇
懃	勤
應	応
懐	懷
懞	蒙
懴	懺
懺	懴
懽	歡
戀	戀
戛	戞
戝	賊
戞	戛
戦	戰
戮	戮
戯	戲
戰	戦
戱	戲
戶	戸
戸	戶
戻	戾
戼	卯
戾	戻
扁	碥
扇	煽
扐	朸
払	拂
扛	摃
扞	擀
扠	搋
扯	撦
扱	插
扵	于
扺	抵
抃	拚
抉	刔
抜	拔
択	擇
抱	抔
抵	扺
抻	伸
拂	払
拉	拉
拊	撫
拏	拏
拓	拓
拔	抜
拕	拖
拖	拕
拚	抃
拜	拝
拝	拜
拡	擴
拴	揎
拿	拏
挅	挆
挆	挅
挙	舉
捆	綑
捍	扞
捜	搜
捲	卷
捴	總
捶	搥
捻	捻
掏	搯
掘	撅
掠	掠
掲	揭
掻	搔
揎	拴
插	扱
揭	掲
揯	搄
揷	插
揺	搖
搃	總
搆	構
搔	掻
搖	揺
搗	擣
搜	捜
搥	捶
搧	煽
搨	搭
搭	搨
搯	掏
摂	攝
摃	扛
摒	屏
摭	拓
撃	擊
撅	掘
撚	撚
撦	扯
撫	拊
撲	攴
撹	攪
擀	扞
擄	擄
擇	択
擊	撃
據	拠
擣	搗
擧	舉
擬	儗
攅	攢
攝	摂
攢	攅
攴	撲
攵	夊
收	収
攷	考
效	効
敍	叙
敎	教
敓	敚
敘	敍
教	敎
敚	敓
敠	敪
敩	斅
敻	夐
敽	敿
敿	敽
斅	斆
斆	斅
斈	學
斉	齊
斍	覺
斎	齋
斤	觔
旅	旅
既	旣
旣	既
旦	蛋
旭	旯
旮	旭
旯	旭
昇	升
易	易
昚	愼
昜	陽
映	暎
春	萅
是	昰
昰	是
昶	暢
昿	曠
晃	晄
晄	晃
晚	晩
晢	晰
晩	晚
晰	晢
晴	晴
暁	曉
暋	忞
暎	映
暖	煖
暗	晻
暦	曆
暨	曁
暴	暴
暸	瞭
曄	曅
曅	曄
曉	暁
曠	昿
曡	疉
曳	曵
更	更
曵	曳
曶	㫚
曹	曺
曽	曾
曾	曽
朂	勗
朌	頒
朐	胊
朖	朗
朗	朗
望	朢
朞	期
期	朞
朢	望
朦	蒙
朩	等
本	夲
札	箚
朵	朶
朶	朵
朸	扐
李	李
杠	槓
杯	盃
松	枩
枀	松
极	極
枏	楠
林	林
枩	松
枴	拐
枾	柿
柆	拉
柏	栢
柒	漆
查	査
柩	柾
柰	奈
柴	茈
査	查
柾	柩
柿	枾
栄	榮
栗	慄
栝	檜
核	覈
桁	航
桌	棹
桑	桒
桒	桑
桜	櫻
桟	棧
桮	杯
梁	梁
梅	楳
梨	梨
梹	檳
棊	棋
棧	桟
棹	桌
椒	茭
椘	楚
検	檢
椫	樿
椶	棕
楂	查
楕	橢
楙	茂
楚	椘
楜	胡
楠	枏
楡	榆
楳	梅
楽	樂
概	槪
榆	楡
榘	矩
榦	乾
槅	核
槇	槙
槓	杠
様	樣
槙	槇
槜	檇
槻	規
樂	樂
樐	櫓
樓	樓
樣	様
権	權
樽	罇
樿	椫
橇	鞒
橢	楕
橦	幢
檇	槜
檘	蘗
檜	栝
檢	検
檳	梹
檼	櫽
櫂	棹
櫉	櫥
櫓	櫓
櫥	櫉
櫽	檼
欄	欄
權	権
欒	灤
欝	鬱
欠	缺
欣	忻
欲	慾
欸	唉
歉	欠
歓	歡
歛	斂
歡	驩
止	只
歧	岐
歩	步
歯	齒
歲	亗
歳	歲
歴	歷
歸	帰
歹	歺
歺	歹
殀	夭
殒	隕
殞	隕
殱	殲
殺	殺
殻	殼
毎	每
每	毎
毓	育
毗	毘
毬	球
氂	犛
気	氣
氣	気
氷	冰
氽	尿
氾	泛
汇	彙
汎	泛
汙	汚
汚	汙
污	汙
沅	源
沉	瀋
沍	冱
沖	盅
沢	澤
沨	渢
沱	沲
沲	沱
沵	濔
泊	泺
泖	茅
泙	洴
泛	汎
泝	溯
泥	泥
洌	冽
洚	洪
洛	洛
洟	涕
洪	洚
洴	泙
流	流
浄	淨
浉	溮
浚	濬
浜	濱
浩	澔
浪	浪
涉	渉
涌	湧
涕	洟
涙	淚
涚	涗
涜	瀆
涢	溳
涸	凅
涼	凉
淋	淋
淒	凄
淚	淚
淡	澹
淨	凈
淫	婬
淸	清
清	淸
渇	渴
済	濟
渉	涉
渋	澀
渓	溪
渕	淵
渢	沨
渴	渇
游	逰
湟	況
湧	涌
湿	溼
満	滿
溁	濚
溇	漊
溈	潙
溉	漑
溌	潑
源	厵
準	凖
溜	溜
溪	渓
溮	浉
溯	泝
溳	涢
溺	尿
溼	濕
滑	磆
滟	灔
漆	柒
漊	溇
漏	漏
漑	溉
漱	潄
漾	瀁
潀	潨
潅	灌
潑	溌
潙	溈
潨	潀
潸	𣽽
澀	澁
澁	澀
澄	澂
澑	溜
澔	浩
澙	潟
澛	瀂
澤	沢
澹	淡
濇	澀
濔	沵
濚	溁
濜	浕
濬	浚
濳	潛
濶	闊
濼	泊
濾	濾
瀁	漾
瀂	澛
瀒	澀
瀨	瀬
瀬	瀨
瀰	彌
灌	潅
灎	灔
灔	灩
灧	灔
灮	光
災	烖
炅	耿
炔	耿
炙	炙
炤	照
炮	砲
炯	烱
炰	炮
為	爲
烉	煥
烖	災
烙	烙
烱	炯
焔	焰
焦	焳
焭	煢
焰	焔
焼	燒
煅	鍛
煉	煉
煑	煮
煕	熙
煥	烉
照	炤
煮	煑
煽	搧
熈	熙
熏	燻
熔	鎔
熙	煕
熹	熺
熺	熹
燎	燎
燐	燐
燕	鷰
燗	爛
燣	燷
燷	燣
燻	熏
爋	𤑕
爐	爐
爲	為
爼	俎
牀	床
牆	墻
牋	箋
牠	它
牢	牢
牦	犛
牴	觝
犁	犂
犂	犁
犇	奔
犛	髦
犠	犧
犲	豺
狢	貉
狼	狼
猟	獵
猪	猪
猾	獪
獎	奬
獣	獸
獪	猾
獵	獵
玅	妙
玆	茲
率	率
玙	璵
玟	珉
玲	玲
珉	玟
珍	珎
珎	珍
珞	珞
珶	瑅
琅	瑯
理	理
琉	琉
琎	璡
琱	雕
瑅	珶
瑩	瑩
瑯	琅
瑸	璸
璘	璘
璡	琎
璵	玙
璸	瑸
瓶	缾
瓷	甆
甁	瓶
甆	瓷
甚	什
甜	甛
甞	嘗
産	產
甪	角
畄	留
畆	畝
界	畍
畍	界
畒	畝
留	畄
畝	畮
略	畧
畧	略
番	蹯
畫	画
畬	畭
畭	畬
畮	畝
異	異
畲	畬
畳	疊
畵	畫
疉	曡
疊	曡
疋	匹
痢	痢
痩	瘦
痲	痳
痳	痲
瘘	瘺
瘦	痩
癒	愈
癛	癝
癨	霍
癩	癩
発	發
發	発
百	佰
皁	皂
皂	皁
皈	歸
皋	皐
皐	皋
皷	鼓
皼	鼓
盅	沖
盇	盍
益	益
盍	盇
省	省
眘	愼
眙	瞪
眞	真
真	眞
眾	衆
睿	叡
瞪	眙
瞭	了
矇	蒙
矈	矏
矏	矈
矢	笶
矩	榘
研	硎
砕	碎
砧	碪
砲	炮
砿	礦
硎	研
硚	礄
硫	硫
硬	峺
硵	磠
硷	鹼
碌	碌
碎	砕
碕	崎
碥	扁
碪	砧
碯	瑙
磆	滑
磊	磊
磻	磻
礄	硚
礆	險
礡	礴
礪	礪
礮	炮
礴	礡
礼	礼
祕	秘
祗	只
祘	算
神	神
祥	祥
祿	祿
福	福
禥	祺
禮	禮
私	厶
秊	秊
秏	耗
秐	耘
稀	希
稚	穉
稜	稜
稟	廪
稲	稻
稻	稲
稽	乩
稿	稾
穂	穗
穅	糠
穉	稚
穐	秋
穗	穂
穞	穭
穣	穰
穭	穞
穰	穣
穽	阱
窗	窓
窯	窰
窰	窯
竃	灶
立	立
竒	奇
竖	豎
竜	龍
竝	並
竢	俟
竪	豎
競	竸
竸	競
竾	篪
笆	巴
笑	咲
笠	笠
笻	筇
筇	笻
等	朩
筋	觔
筐	筺
答	荅
策	筞
筞	策
筱	篠
签	籤
筿	篠
箇	個
箋	牋
算	祘
箚	剳
箝	钳
箬	篛
箳	簈
節	罇
篛	箬
篠	筿
篡	簒
篪	竾
篭	籠
篯	籛
篲	彗
簈	箳
簑	蓑
簔	簑
簘	簫
簾	簾
籐	籘
籔	藪
籖	籤
籘	籐
籠	籠
籤	籖
粋	粹
粒	粒
粗	麄
粛	肅
粥	鬻
粫	糯
粹	粋
粽	糭
精	精
糊	胡
糖	糖
糠	穅
糤	馓
糭	糉
糯	粫
糸	絲
糺	糾
系	繫
糾	糺
紐	紐
索	索
紥	紮
紬	綢
紮	扎
絃	弦
絋	纊
経	經
絏	紲
絖	纊
絝	褲
絲	纟
絵	繪
絶	絕
綉	繡
綑	捆
經	経
継	繼
続	續
綠	綠
綳	繃
総	總
緑	綠
緒	緖
緖	緒
緣	縁
緼	縕
縁	緣
縂	總
縄	繩
縦	縱
縴	纤
總	総
繁	緐
繃	綳
繈	繦
繊	纖
繋	繫
繍	繡
繙	翻
繡	繍
繢	繪
繦	繈
繩	縄
繪	缋
繫	繋
繿	襤
纇	颣
纉	纘
纊	絋
纎	纖
纒	纏
纘	纉
纤	縴
线	線
绔	褲
绝	絕
绣	繡
绱	緔
绷	繃
绿	綠
缋	繪
缐	線
缰	繮
缶	罐
缷	卸
缺	欠
缾	瓶
罇	樽
罐	缶
罗	囉
罘	罦
罥	羂
罪	辠
置	寘
罰	罸
罶	羀
罹	罹
羀	罶
羂	罥
羃	冪
羅	羅
羇	羈
羈	覊
羚	羚
羝	牴
羡	羨
羣	群
群	羣
羮	羹
羹	羮
羽	羽
翄	翅
翅	翄
翆	翠
翚	翬
翠	翆
翬	翚
翱	翺
翶	翱
翺	翱
翻	繙
翽	翙
老	耂
耂	老
考	攷
耇	耈
耈	耇
耉	耈
耗	秏
耘	秐
耡	鋤
耤	藉
耽	躭
耿	炅
聆	聆
聖	堊
聟	婿
聡	聰
聨	聯
聫	聯
聮	聯
聯	聨
聰	聡
聴	聽
聼	聽
聾	聾
聿	肀
肀	聿
肅	粛
肆	四
肉	宍
肋	肋
肐	胳
股	脵
肯	肻
育	毓
肻	肯
胄	冑
胊	朐
胝	郅
胞	脬
胡	楜
胭	臙
胳	肐
胷	胸
胸	胷
胼	腁
脇	脅
脏	髒
脣	唇
脧	朘
脬	胞
脲	尿
脳	腦
脵	股
腁	胼
腘	膕
腟	膣
腸	膓
膕	腘
膘	臕
膣	腟
膸	髓
臈	臘
臏	髕
臓	臟
臕	膘
臙	胭
臨	臨
舃	舄
舄	舃
舉	擧
舍	舎
舎	舍
舖	鋪
舗	鋪
舘	館
舡	船
舩	船
舮	櫓
舵	柁
舶	艊
船	舩
舻	櫓
艊	舶
艣	櫓
艪	櫓
艫	櫓
良	良
艳	豔
艴	勃
艷	豔
艽	韭
芊	茜
芘	蔽
芭	巴
芸	藝
苅	刈
苎	蒙
苑	菀
若	若
苺	莓
苽	菇
苿	菋
茅	泖
茆	茅
茈	柴
茘	荔
茭	椒
茲	玆
茶	茶
荅	答
荘	莊
荝	萴
荽	萎
莆	蒲
莊	荘
莓	苺
莵	菟
获	穫
莼	蒓
菀	苑
菇	苽
菋	苿
菔	蔔
菝	蔽
菟	莵
菫	堇
華	崋
菰	苽
菱	菱
菷	帚
菻	麻
萅	春
萆	蔽
萌	萠
萎	荽
萚	蘀
萠	萌
萼	蕚
落	落
葉	葉
葢	蓋
葫	胡
葬	塟
蒍	蔿
蒓	蓴
蒙	懞
蒲	莆
蓆	席
蓖	芘
蓡	參
蓴	蒓
蓼	蓼
蔔	菔
蔵	藏
蔽	芘
蔿	蒍
蕊	蘂
蕋	蕊
蕚	萼
蕴	蘊
薑	姜
薫	薰
薬	藥
薰	薫
薺	萕
藉	借
藏	蔵
藝	兿
藥	薬
藪	籔
藴	蘊
蘀	萚
蘂	蕊
蘆	蘆
蘏	蘔
蘓	蘇
蘔	蘏
蘖	蘗
蘗	檘
蘿	蘿
虎	乕
虐	乇
處	処
虖	呼
虜	虜
虺	蝰
蚃	蠁
蚊	螡
蛋	旦
蛍	螢
蛔	蜖
蛛	鼄
蜖	蛔
蜘	鼅
蜹	蚋
蜺	霓
蝋	蠟
蝨	虱
蝴	胡
蝿	蠅
螗	螳
螢	蛍
螳	螗
螵	蜱
螺	螺
蟁	蚊
蟇	蟆
蟒	蠎
蠁	蚃
蠎	蟒
蠏	蟹
蠢	惷
蠧	蠹
蠹	蠧
衄	衂
衆	眾
行	行
街	亍
衞	衛
袅	嬝
袖	褎
袴	褲
裂	裂
裊	嬝
裏	里
裙	帬
裠	裙
裴	裵
裵	裴
裸	裸
複	復
褒	襃
褓	褴
褲	綯
褴	褓
襃	褒
襕	襴
襤	襤
襪	韈
襴	幱
襾	西
西	覀
覀	西
覆	復
覇	霸
覈	核
覉	羈
覊	羈
規	槻
覙	覼
覚	覺
観	觀
覵	覸
覸	覵
覺	覚
覽	覧
觀	覌
角	甪
觔	斤
觝	牴
解	觧
觧	解
言	訁
訛	譌
訳	譯
訶	呵
証	證
詟	讋
詧	察
詶	酬
詻	咯
誒	唉
說	説
説	說
読	讀
諌	諫
論	論
諠	喧
諩	譜
諮	咨
謡	謠
謼	呼
譁	哗
譌	訛
譟	噪
譯	訳
譱	善
譲	讓
譾	謭
讀	讀
讃	讚
讅	谉
讆	讏
讋	詟
讌	燕
讎	仇
讐	仇
讙	歡
讚	讃
讠	言
诃	呵
诶	唉
诸	諸
谉	讅
谘	咨
谣	謠
谫	謭
豊	豐
豐	豊
豔	艶
豜	豣
豣	豜
豫	予
豺	犲
貉	狢
貊	貘
貌	皃
貘	貊
貭	質
貮	二
貳	二
賉	恤
賊	戝
賔	賓
賛	贊
賣	売
質	貭
賬	帳
賸	剩
贊	賛
贗	贋
贜	贓
账	帳
贰	二
赝	贋
走	赱
赱	走
趁	趂
趂	趁
跥	跺
路	路
跺	跥
踨	蹤
蹟	跡
蹤	踨
躗	躛
躛	躗
躭	耽
躰	體
躱	躲
躲	躱
軆	體
転	轉
軣	轟
軽	輕
軿	輧
輌	輛
輛	輌
輦	輦
輧	軿
輪	輪
輻	輻
輼	轀
轉	転
轢	轢
辟	避
辠	罪
辢	辣
辣	辢
辧	辨
辨	弁
辰	辰
辺	邊
迂	遇
迥	逈
迨	逮
迬	往
迭	疊
迯	逃
迳	徑
迴	回
迺	乃
逃	迯
逓	遞
逕	徑
連	連
逥	回
逩	奔
逮	迨
逰	游
逸	逸
逹	達
逺	遠
遅	遲
遊	游
遍	徧
遑	徨
遞	逓
遟	遲
遠	逺
遡	溯
遲	遅
遼	遼
避	辟
邉	邊
邏	邏
邑	阝
邢	郉
郄	隙
郅	胝
郉	邢
郎	郞
郞	郎
部	卩
郷	鄉
都	都
鄕	鄉
鄰	隣
鄷	酆
酆	鄷
酉	丣
酔	醉
酝	醞
酢	醋
酧	酬
酪	酪
酬	酧
醉	酔
醋	酢
醖	醞
醗	醱
醤	醬
醴	醴
醻	酬
醼	燕
釀	醸
釆	采
采	釆
釈	釋
里	裏
野	埜
量	量
金	钅
釖	劍
釜	釡
釡	釜
釼	劍
鈎	鉤
鈡	鍾
鈬	鐸
鈴	鈴
鉅	巨
鉗	箝
鉤	鈎
鉱	礦
銕	鐵
銭	錢
銳	鋭
銹	鏽
鋄	錽
鋭	銳
鋳	鑄
錄	録
錬	煉
録	錄
錽	鋄
鍊	鍊
鍛	煅
鍾	钟
鎔	熔
鎭	鎮
鏁	鎖
鏟	剗
鏽	銹
鐘	鍾
鐡	鐵
鐸	鈬
鑑	鑒
鑒	鑑
鑛	礦
鑵	罐
钂	镋
钅	金
钖	锡
钜	巨
钩	鉤
钳	箝
钵	缽
锈	鏽
锐	銳
镋	钂
镚	錋
閇	閉
閉	閇
閙	鬧
関	關
閤	合
閧	哄
閭	閭
閱	閲
閲	閱
闇	暗
闔	閤
闗	關
闘	鬥
闫	閻
阅	閱
阖	閤
阜	阝
阝	邑
阨	厄
阬	坑
阮	阮
阯	址
阱	穽
陋	陋
降	降
陏	隋
陔	垓
陜	陝
陝	陜
陞	升
陥	陷
陵	陵
陷	陥
険	險
陽	昜
隆	隆
隋	陏
隕	殒
隠	隱
隣	鄰
隷	隸
隸	隷
雁	鳫
雑	雜
雜	雑
雞	鷄
雠	仇
離	離
零	零
雷	雷
霊	靈
霍	癨
露	露
霸	覇
靆	叇
靈	靈
靉	叆
靑	青
青	靑
靔	靝
靖	靖
靚	靜
靝	靔
靭	韌
靱	韌
鞌	鞍
鞍	鞌
鞒	橇
韈	襪
韤	襪
韭	艽
韮	韭
韲	齏
頋	顧
頒	朌
領	領
頚	頸
頤	頉
頬	頰
頹	頽
頼	賴
頽	頹
顔	顏
顕	顯
顚	顛
類	類
顯	顕
须	須
颓	頹
颜	顏
颣	纇
飄	飃
飜	翻
食	饣
飠	食
飪	餁
飮	飲
飰	飯
飲	飮
飼	飼
餁	飪
餝	飾
餠	餅
館	館
餹	糖
餽	饋
饋	餽
饥	飢
饮	飮
馈	餽
馓	糤
馱	駄
駁	駮
駄	馱
駅	驛
駆	驅
駈	驅
駞	駝
駡	罵
駢	騈
駮	駁
駱	駱
騃	呆
騈	駢
騌	鬃
騒	騷
験	驗
騣	鬃
騨	驒
騺	驇
驇	騺
驒	騨
驩	歡
骂	罵
骔	鬃
骫	骪
骵	體
髄	髓
髌	臏
髓	膸
髕	臏
髗	臚
高	髙
髙	高
髣	仿
髦	犛
髪	髮
髯	髥
髴	彿
鬃	骔
鬥	鬬
鬦	鬥
鬨	哄
鬪	鬥
鬬	鬥
鬭	鬥
鬰	鬱
鬱	鬰
鬻	粥
魯	魯
鮮	尟
鯋	鯊
鰌	鰍
鰛	鳁
鱉	龞
鱓	鱔
鱗	鱗
鳁	鰛
鳫	雁
鳮	雞
鳯	鳳
鳳	鳯
鴈	雁
鴉	鵶
鴎	鷗
鴬	鶯
鵉	鸞
鵞	鵝
鶏	雞
鷄	雞
鷏	鷆
鷰	燕
鷺	鷺
鸡	雞
鹸	鹼
鹼	硷
鹿	鹿
麁	粗
麄	粗
麓	梺
麟	麟
麪	麵
麴	麹
麵	麺
麺	麵
麻	菻
麼	麽
麽	麼
黎	黎
黑	黒
黒	黑
默	黙
黙	默
點	奌
鼂	鼌
鼄	蛛
鼅	蜘
鼈	鱉
鼌	鼂
鼓	皼
鼕	冬
鼠	鼡
鼡	鼠
齋	斎
齏	韲
齒	歯
齡	齢
齢	齡
齧	嚙
齩	咬
龎	龐
龐	厐
龝	䆋
龢	和
豈	豈
更	更
車	車
賈	賈
滑	滑
串	串
句	句
龜	龜
龜	龜
契	契
金	金
喇	喇
奈	奈
懶	懶
癩	癩
羅	羅
蘿	蘿
螺	螺
裸	裸
邏	邏
樂	樂
洛	洛
烙	烙
珞	珞
落	落
酪	酪
駱	駱
亂	亂
卵	卵
欄	欄
爛	爛
蘭	蘭
鸞	鸞
嵐	嵐
濫	濫
藍	藍
襤	襤
拉	拉
臘	臘
蠟	蠟
廊	廊
朗	朗
浪	浪
狼	狼
郎	郎
來	來
冷	冷
勞	勞
擄	擄
櫓	櫓
爐	爐
盧	盧
老	老
蘆	蘆
虜	虜
路	路
露	露
魯	魯
鷺	鷺
碌	碌
祿	祿
綠	綠
菉	菉
錄	錄
鹿	鹿
論	論
壟	壟
弄	弄
籠	籠
聾	聾
牢	牢
磊	磊
賂	賂
雷	雷
壘	壘
屢	屢
樓	樓
淚	淚
漏	漏
累	累
縷	縷
陋	陋
勒	勒
肋	肋
凜	凜
凌	凌
稜	稜
綾	綾
菱	菱
陵	陵
讀	讀
拏	拏
樂	樂
諾	諾
丹	丹
寧	寧
怒	怒
率	率
異	異
北	北
磻	磻
便	便
復	復
不	不
泌	泌
數	數
索	索
參	參
塞	塞
省	省
葉	葉
說	說
殺	殺
辰	辰
沈	瀋
拾	十
若	若
掠	掠
略	略
亮	亮
兩	兩
凉	涼
梁	梁
糧	糧
良	良
諒	諒
量	量
勵	勵
呂	呂
女	女
廬	廬
旅	旅
濾	濾
礪	礪
閭	閭
驪	驪
麗	麗
黎	黎
力	力
曆	曆
歷	歷
轢	轢
年	年
憐	憐
戀	戀
撚	撚
漣	漣
煉	煉
璉	璉
秊	秊
練	練
聯	聯
輦	輦
蓮	蓮
連	連
鍊	鍊
列	列
劣	劣
咽	咽
烈	烈
裂	裂
說	說
廉	廉
念	念
捻	捻
殮	殮
簾	簾
獵	獵
令	令
囹	囹
寧	寧
嶺	嶺
怜	怜
玲	玲
瑩	瑩
羚	羚
聆	聆
鈴	鈴
零	零
靈	靈
領	領
例	例
禮	禮
醴	醴
隸	隸
惡	惡
了	了
僚	僚
寮	寮
尿	尿
料	料
樂	樂
燎	燎
療	療
蓼	蓼
遼	遼
龍	龍
暈	暈
阮	阮
劉	劉
杻	杻
柳	柳
流	流
溜	溜
琉	琉
留	留
硫	硫
紐	紐
類	類
六	六
戮	戮
陸	陸
倫	倫
崙	崙
淪	淪
輪	輪
律	律
慄	慄
栗	栗
率	率
隆	隆
利	利
吏	吏
履	履
易	易
李	李
梨	梨
泥	泥
理	理
痢	痢
罹	罹
裏	裏
裡	裏
里	里
離	離
匿	匿
溺	溺
吝	吝
燐	燐
璘	璘
藺	藺
隣	鄰
鱗	鱗
麟	麟
林	林
淋	淋
臨	臨
立	立
笠	笠
粒	粒
狀	狀
炙	炙
識	識
什	什
茶	茶
刺	刺
切	切
度	度
拓	拓
糖	糖
宅	宅
洞	洞
暴	暴
輻	輻
行	行
降	降
見	見
廓	廓
兀	兀
嗀	嗀
塚	塚
晴	晴
凞	凞
猪	猪
益	益
礼	礼
神	神
祥	祥
福	福
靖	靖
精	精
羽	羽
蘒	蘒
諸	諸
﨣	𧺯
逸	逸
都	都
飯	飯
飼	飼
館	館
鶴	鶴
𣁀	𧥙
𣽽	潸
𤑕	爋
𧥙	𣁀
𧺯	﨣
𨬕	𨬟
𨬟	𨬕
