㐀	丘
㐅	五
㐫	凶
㐮	襄
㐯	庸
㐱	鬒
㐴	攀
㐵	儒
㑁	𠭴
㑄	侮
㑌	尩
㑝	𢙱
㒇	儛
㒋	廝
㒚	穩
㒞	儶
㒰	全
㒲	財
㒷	興
㓁	网
㓮	彫
㓷	劓
㓸	斲
㔍	䥷
㔱	斞
㔾	卩
㕑	𢊍
㕚	爪
㕞	刷
㗖	啖
㗳	嗒
㘅	銜
㙮	塔
㙳	轗
㚝	奞
㚣	姣
㛛	娠
㝃	娩
㝛	宿
㝵	礙
㞐	居
㟗	邠
㠊	嶇
㠯	以
㠶	帆
㡘	𢅏
㡿	斥
㣶	邅
㣺	心
㣼	忍
㤒	笨
㤵	慈
㥃	悶
㥵	慁
㦧	憯
㧃	收
㧖	扼
㧜	擸
㨉	抿
㨗	捷
㨨	㩅
㨼	撂
㩁	搉
㩅	㨨
㩜	攬
㩹	𢶣
㪅	更
㪯	舉
㫃	偃
㫎	幑
㫚	昒
㬅	曼
㬱	朁
㬹	踭
㭨	椰
㮣	槩
㯃	漆
㯭	樐
㯶	棕
㯽	檳
㰍	櫳
㱿	殼
㲒	勽
㲓	毧
㳄	涎
㴑	溯
㴔	潝
㵒	沸
㷉	熨
㷠	燐
㷻	煳
㽣	域
㽽	痼
㾙	脪
㿟	皦
㿷	糙
䀋	鹽
䀠	瞿
䀢	瞬
䀹	睫
䂀	𥋟
䂫	夯
䃉	珉
䃘	硜
䄃	殃
䄍	蜡
䄯	𢆞
䄺	稊
䆋	秋
䆔	竉
䆫	窓
䈇	罩
䉵	饌
䊜	糰
䋲	繩
䌥	縯
䌫	纜
䏕	飪
䐰	饈
䒒	苕
䔛	檾
䕌	稚
䖈	虐
䖍	虔
䖏	処
䖟	蝱
䖣	蚤
䖵	蜫
䘑	脉
䘚	卒
䘺	綻
䙝	褻
䚎	𥅾
䛡	話
䛻	誘
䛼	譭
䜊	嘈
䜶	豇
䝋	豵
䝜	狻
䝤	獠
䞓	赬
䠱	躅
䢙	敗
䣩	醇
䤍	𨢥
䥀	捵
䥨	鑢
䥷	㔍
䦓	覘
䨘	霰
䩞	韂
䪊	龓
䪿	囟
䬒	颼
䬡	翥
䭾	馱
䯌	尻
䯻	髻
䰗	鬮
䱇	鱓
䱷	漁
䱽	鯧
䴹	餜
䵑	䵒
䵒	䵑
䶏	涕
一	弌
七	柒
万	卍
三	叁
与	與
丐	匃
丘	㐀
东	東
丟	丢
両	兩
丢	丟
两	両
並	幷
个	個
乃	迺
么	幺
义	義
乔	喬
乚	隱
九	玖
乱	亂
亂	乱
予	余
争	爭
亊	事
事	亊
二	弍
于	扵
亏	於
五	㐅
亗	岁
亝	齊
亡	兦
亲	榛
人	亻
亻	人
亼	集
亾	亡
仇	讎
从	從
他	她
仙	僊
仝	同
仟	千
以	㠯
任	仼
仼	任
仾	低
仿	倣
伀	彸
伃	妤
会	會
伭	玄
伱	你
伷	冑
佇	竚
佋	紹
低	仾
佑	祐
体	體
佗	它
余	予
你	伱
佰	百
併	𠊧
侁	駪
侂	託
侅	賅
來	来
侎	敉
侖	崙
侚	殉
侣	侶
侮	㑄
侶	侣
俈	嚳
俓	徑
俞	兪
俟	竢
俯	頫
俻	備
倈	徠
個	个
倏	倐
倐	倏
倖	幸
倘	儻
倣	仿
値	值
值	値
偁	穪
偃	㫃
偊	踽
偐	贋
偒	蕩
健	徤
偪	逼
偷	偸
偸	偷
偺	昝
傁	叟
傌	罵
傏	搪
傑	杰
傘	繖
備	俻
傜	徭
傻	儍
傽	慞
僊	仙
僱	雇
儆	警
儍	傻
儒	㐵
儓	檯
儛	㒇
儭	襯
儶	㒞
儻	倘
兌	兑
兎	兔
兑	兌
兔	兎
兦	亡
全	㒰
兩	両
兪	俞
八	捌
兮	𠔃
兹	玆
冂	坰
冄	冉
冉	冄
冋	冂
冑	伷
冒	冒
冗	宂
冤	寃
冩	寫
冪	羃
冫	氷
冰	冫
冱	沍
冲	沖
决	決
况	況
凂	浼
凄	淒
准	準
凈	淨
凉	涼
减	減
凑	湊
凛	懔
凡	凢
凢	凡
凣	凡
処	䖏
凳	櫈
凴	憑
凶	㐫
凹	𠕄
函	凾
凾	函
刀	刂
刂	刀
刃	刄
刄	刃
刅	創
刊	刋
刋	刊
刓	园
刘	劉
删	刪
刦	刧
刧	刦
刨	鉋
利	𥝢
刪	删
刱	創
刴	剁
刷	㕞
刼	劫
剁	刴
剃	鬀
剋	尅
剗	剷
剦	閹
剩	賸
剪	翦
剳	劄
創	刅
剷	剗
剿	𠞰
劄	剳
劈	擗
劉	刘
劍	劒
劎	劔
劒	劍
劓	㓷
劔	劎
劝	勸
办	辦
劫	刦
効	效
勄	敏
勅	勑
勑	倈
勖	勗
勗	勖
勛	勳
勰	協
勳	勛
勸	劝
勹	包
勻	匀
勽	㲒
匀	勻
匃	丐
匄	匃
包	勹
匆	悤
匈	胸
匊	掬
匋	陶
匏	瓟
匘	腦
匙	鍉
匝	帀
匧	篋
匯	滙
匱	樻
匳	奩
匵	櫝
匹	疋
医	醫
千	仟
卄	廿
卉	芔
卌	𠦌
卍	万
卐	卍
卒	䘚
協	勰
单	單
博	愽
卧	臥
卩	㔾
卬	卭
卭	卬
即	卽
却	卻
卹	恤
卻	却
卽	即
厄	戹
历	厲
厎	砥
厓	崖
厖	庬
厘	釐
厠	廁
厤	曆
厦	廈
厨	廚
厩	廐
厪	廑
厮	㒋
厰	廠
厲	历
厶	某
厷	肱
厹	叴
叁	三
參	叅
叅	參
双	雙
収	收
叔	尗
变	變
叙	敍
叜	傁
叟	傁
叠	曡
叡	睿
叢	樷
叨	饕
只	子
叫	呌
台	臺
叴	厹
叵	尀
号	號
吃	喫
吊	弔
同	仝
吒	咤
吚	咿
吝	恡
吞	呑
吟	唫
吣	唚
吨	啍
听	聽
吲	哂
吳	呉
吶	訥
吸	噏
吹	龡
吻	呡
吿	告
呆	獃
呉	吳
告	吿
呌	叫
呑	吞
呠	歕
呡	吻
周	週
呪	詋
咀	觜
咂	𠯗
咊	和
和	咊
咏	詠
咒	呪
咤	吒
咨	嗞
咩	哶
咬	齩
咱	偺
咲	笑
咳	欬
咷	啕
咽	嚥
咿	吚
哂	吲
响	響
哦	誐
哲	喆
哴	喨
哶	咩
唁	喭
唇	脣
唉	欸
唊	硤
唚	吣
唫	吟
唬	諕
唾	涶
啃	齦
啍	吨
啎	忤
啓	啟
啕	咷
啖	㗖
啗	㗖
啜	欼
啞	瘂
啟	啓
啣	㘅
啼	嗁
喂	餧
喃	諵
喆	哲
喐	郁
喒	昝
喜	憙
喧	諠
喨	哴
喫	吃
喬	乔
喭	唁
單	单
喿	噪
嗁	啼
嗅	齅
嗉	膆
嗒	㗳
嗞	咨
嗥	嚎
嗽	瘶
嘆	歎
嘈	䜊
嘍	謱
嘗	甞
嘩	譁
嘯	歗
嘱	囑
嘴	咀
嘷	嗥
嘿	默
噂	譐
噉	㗖
噏	吸
噐	器
噑	嚎
噦	𧬨
器	噐
噪	喿
噴	呠
嚎	嗥
嚥	咽
嚬	顰
嚳	俈
嚵	饞
嚹	𡅈
囁	讘
囑	嘱
囓	齧
囘	囬
四	肆
回	囘
囟	䪿
囤	𥫱
囪	囱
囬	囘
园	刓
囮	𡈙
囯	國
困	睏
囱	囪
圅	函
國	囯
圕	圖
圖	圕
圝	圞
圞	圝
圢	町
圣	聖
圬	杇
圭	珪
坆	墳
坋	坌
坌	坋
坎	埳
坏	坯
坑	阬
坛	壇
坟	墳
坤	堃
坭	泥
坯	坏
坰	冂
坵	丘
垔	陻
垛	垜
垜	垛
垻	壩
埇	甬
埜	野
域	㽣
埳	坎
埶	蓺
執	执
埽	掃
堃	坤
堇	菫
堈	缸
堘	塍
堙	垔
堤	隄
堦	階
堭	隍
報	报
場	塲
堿	鹼
塍	堘
塐	塑
塑	塐
塔	㙮
塟	葬
塡	窴
塢	隝
塤	壎
塩	鹽
塲	場
塹	壍
墈	磡
墖	塔
墝	磽
墤	隤
墫	樽
墰	罈
墳	坆
墻	廧
壇	坛
壍	塹
壎	塤
壐	璽
壜	墰
壩	垻
声	聲
壳	㱿
壹	一
壻	婿
壽	寿
夀	壽
夅	降
変	變
够	彀
夠	够
夢	梦
夣	夢
天	靝
夯	䂫
夸	誇
奇	竒
奈	柰
奎	㚝
奔	犇
奕	弈
奞	㚝
奩	匳
奶	妳
她	他
妊	姙
妒	妬
妙	玅
妝	粧
妤	伃
妬	妒
妳	奶
姆	姥
姉	姊
姊	姉
姍	姗
姗	姍
姙	妊
姣	㚣
姥	姆
姻	婣
娘	孃
娠	㛛
娩	㝃
娬	嫵
婣	姻
婦	媍
婬	淫
婿	壻
媆	嫩
媍	婦
媿	愧
嫉	𡜱
嫕	嫛
嫛	嫕
嫩	媆
嫫	嬷
嫵	娬
嫺	嫻
嫻	嫺
嬌	撟
嬭	奶
嬰	孾
嬷	嫫
孀	霜
孃	娘
子	只
孭	𧴯
學	斈
孼	孽
孽	孼
孾	嬰
宂	冗
它	佗
完	烟
宐	宜
宜	宐
宝	寳
宴	讌
宻	密
宼	寇
宿	㝛
寃	冤
密	宻
寇	宼
寍	寧
寔	實
寕	寜
寗	甯
寘	置
寚	宝
寜	寕
察	詧
寠	窶
寡	關
實	寔
寧	寍
寨	砦
寫	冩
寳	宝
寵	𠖥
寶	宝
对	對
寿	壽
尀	叵
尃	旉
尅	剋
将	𤕭
將	𤕭
專	耑
對	对
尒	尔
尔	尒
尗	叔
尢	尣
尣	尢
尨	狵
尩	㑌
尰	腫
尲	尷
尷	尲
尸	屍
尻	䯌
尽	盡
居	㞐
屆	届
屉	屜
届	屆
屍	尸
屜	𡲕
属	𡱆
屣	蹝
屬	属
岁	亗
岡	崗
岨	砠
岩	巖
峒	洞
峨	峩
峩	峨
峭	陗
峯	峰
峰	峯
崒	崪
崔	磪
崖	厓
崗	岡
崘	崙
崙	侖
崧	嵩
崪	崒
嵗	歲
嵠	谿
嵩	崧
嶃	磛
嶄	巉
嶇	㠊
嶎	蔚
嶝	磴
巉	嶄
巍	魏
巖	岩
巛	川
川	巛
巡	廵
巤	鬣
帀	匝
帆	㠶
帋	紙
帒	袋
帙	袠
帚	箒
帬	裙
帮	幫
帳	賬
幂	鼏
幇	帮
幕	幙
幙	幕
幞	襮
幟	旘
幡	旛
幫	帮
幵	开
并	並
幷	並
幸	倖
幺	么
庄	莊
庅	麽
床	牀
庙	廟
庬	厖
庵	菴
庸	㐯
庾	斞
廀	廋
廁	厠
廈	厦
廋	廀
廌	豸
廐	厩
廑	厪
廕	蔭
廚	厨
廝	㒋
廟	庙
廠	厰
廧	墻
廱	雝
廵	巡
廸	迪
廹	迫
廻	回
廼	乃
廿	卄
开	幵
弈	奕
弊	𡚁
弋	𢍺
弌	一
弍	二
弔	吊
弢	韜
弦	絃
強	强
强	強
彀	够
彊	強
彐	彑
彑	彐
归	歸
彫	㓮
彬	斌
彷	髣
彸	伀
往	徃
徃	往
徑	俓
徒	𨑒
從	从
徠	倈
御	馭
徤	健
徧	遍
徬	彷
徭	傜
德	悳
徹	澈
心	㣺
忄	心
忍	㣼
忤	啎
忭	昪
忻	欣
忼	慷
怀	懷
怌	懷
怪	恠
怱	匆
怳	恍
恆	恒
恊	勰
恋	戀
恍	怳
恐	𢙢
恒	恆
恠	怪
恡	吝
恤	卹
恥	耻
恩	摁
恿	慂
悁	懁
悅	悦
悊	哲
悋	吝
悐	惕
悚	𢥠
悞	誤
悠	滺
悤	匆
悦	悅
悳	德
悶	㥃
惇	敦
惕	悐
惛	惽
惝	𢠵
惧	懼
惩	懲
惪	德
惺	𢜫
惽	惛
愈	愉
愉	愈
愍	憫
愠	慍
愧	媿
愬	訴
愻	遜
愽	博
愿	願
慁	㥵
慂	恿
慈	㤵
慍	愠
慙	慚
慚	慙
慞	傽
慷	忼
慼	慽
慽	慼
慾	欲
憇	憩
憋	𢠳
憑	凴
憔	顦
憙	喜
憝	譈
憩	憇
憫	愍
憯	㦧
憰	譎
懁	悁
懔	凛
懜	懵
懟	憝
懣	㥃
懥	懫
懫	懥
懲	惩
懵	懜
懷	怀
懼	惧
懽	歡
戀	恋
戉	鉞
戧	創
戯	戲
戱	戲
戲	戯
戹	厄
扅	扊
扊	扅
手	扌
扌	手
扎	紮
扑	撲
托	拓
扞	捍
执	執
扯	撦
扳	攀
扵	于
扼	㧖
抌	舀
抍	拯
抝	拗
报	報
抬	擡
抽	𢭆
抿	㨉
担	擔
拇	𧿹
拏	拿
拓	托
拕	拖
拖	拕
拗	抝
拭	𢂑
拯	抍
拼	摒
拿	拏
挂	掛
挐	拏
挫	繲
挭	骾
挱	挲
挲	挱
挷	搒
挼	捼
捆	綑
捌	八
捍	扞
捏	揑
捓	揶
捦	擒
捬	撫
捵	䥀
捶	箠
捷	㨗
捼	挼
掂	敁
掃	埽
掏	搯
掐	𠜼
掛	挂
掩	揜
掬	匊
掽	碰
揅	研
揑	捏
揜	掩
揝	撍
揦	攋
揪	揫
揫	揪
揶	捓
揸	楂
搃	總
搇	撳
搉	㩁
搒	挷
搖	摇
搗	擣
搜	𢯱
搞	攪
搤	㧖
搪	傏
搫	搬
搬	搫
搭	撘
搯	掏
携	攜
摁	恩
摇	搖
摒	拼
摠	搃
摡	溉
摣	揸
摮	𢳆
撂	㨼
撆	撇
撇	撆
撍	揝
撐	撑
撑	撐
撘	搭
撟	嬌
撦	扯
撫	捬
撲	扑
撳	搇
擃	攮
擄	虜
擋	攩
擒	捦
擔	担
擗	劈
擡	抬
擣	搗
擥	㩜
擧	舉
擲	擿
擸	㧜
擿	擲
攀	㐴
攅	攢
攋	揦
攜	携
攢	攅
攩	擋
攪	搞
攬	㩜
攮	擃
攴	攵
攵	攴
收	㧃
攷	考
敁	掂
敃	暋
效	効
敉	侎
敍	叙
敎	教
敏	勄
敕	勅
敗	䢙
敘	叙
教	敎
敠	敪
敦	惇
敪	敠
敷	尃
敺	驅
斁	𤢕
斅	斆
斆	斅
斈	學
斉	齊
斋	齋
斌	彬
斚	斝
斝	斚
斞	㔱
斤	觔
斥	㡿
断	斷
斲	㓸
斵	斲
斷	断
於	于
斾	旆
旂	旗
旆	斾
旈	旒
旉	尃
旒	旈
旗	旂
旘	幟
旛	幡
无	無
旧	舊
旪	協
时	時
旹	时
昂	昻
明	朙
昏	昬
昒	㫚
昝	偺
映	暎
昪	忭
昬	昏
昵	暱
昷	𥁕
昻	昂
晁	朝
時	时
晅	烜
晉	晋
晋	晉
晒	曬
晡	𣇀
晰	晳
晳	晰
暋	敃
暎	映
暖	煖
暠	皜
暱	昵
暴	虣
曆	厤
曖	瞹
曜	燿
曡	叠
曬	晒
更	㪅
曼	㬅
朁	㬱
會	会
朐	鸜
朙	明
望	朢
朝	晁
朞	稘
朢	望
朳	杷
朴	樸
朵	朶
朶	朵
机	機
朿	莿
杇	圬
村	邨
杝	柂
杠	槓
条	條
来	來
杧	芒
杯	盃
杰	傑
東	东
杷	朳
杸	殳
板	版
枏	楠
果	菓
枬	楠
枱	儓
架	榢
枾	柹
柁	舵
柂	杝
柄	棅
柏	栢
某	厶
柒	七
柚	櫾
柜	櫃
查	査
柰	奈
柳	檉
柹	枾
査	查
标	檁
栒	簨
栖	棲
栛	荔
栢	柏
栰	筏
桌	棹
桼	㯃
梁	樑
條	条
梟	鴞
梦	夢
梨	棃
梲	棳
梹	檳
棃	梨
棅	柄
棊	碁
棋	棊
棐	榧
棑	篺
棕	㯶
棥	樊
棰	槌
棱	稜
棲	栖
棳	梲
棹	桌
椀	盌
椁	槨
椎	槌
椰	㭨
椶	棕
椹	葚
楂	揸
楞	棱
楠	枏
楥	楦
楦	楥
楫	艥
概	槩
榎	檟
榛	亲
榢	架
榧	棐
榨	醡
榮	荣
榴	橊
槀	稿
槊	鎙
槌	棰
槎	楂
槓	杠
槖	橐
槨	椁
槩	㮣
槪	㮣
槹	𣓌
樊	棥
樐	㯭
樑	梁
樚	轆
樷	叢
樸	朴
樻	匱
樽	墫
橆	無
橇	鞽
橊	榴
橐	槖
橓	蕣
橛	橜
橜	橛
機	机
檁	标
檉	柳
檐	簷
檔	欓
檛	簻
檝	楫
檟	榎
檠	𢐧
檣	艢
檯	儓
檳	㯽
檴	穫
檾	䔛
櫂	棹
櫃	匱
櫈	凳
櫌	耰
櫓	㯭
櫝	匵
櫱	蘖
櫳	㰍
櫺	欞
櫾	柚
欓	檔
欝	鬱
欞	櫺
欢	懽
欣	忻
欬	咳
欲	慾
欵	款
欶	𠲿
欸	唉
欹	猗
欼	啜
款	欵
歌	謌
歎	嘆
歕	呠
歗	嘯
歠	啜
歡	懽
歱	踵
歲	亗
歳	歲
歴	曆
歷	曆
歸	归
歹	歺
歺	歹
歿	殁
殁	歿
殃	䄃
殉	侚
殰	𦢌
殳	杸
殻	壳
殼	㱿
殽	淆
毓	育
毗	毘
毘	毗
毡	氈
毧	㲓
氅	鷩
氈	毡
氊	氈
氓	甿
氜	陽
氣	炁
氤	絪
氯	綠
水	氵
氵	水
氷	冫
氼	溺
汎	泛
汙	污
汚	汙
污	汙
決	决
沈	沉
沉	沈
沍	冱
沖	冲
沪	冱
沱	沲
沲	沱
沸	㵒
況	况
泄	洩
泉	洤
泛	汎
泝	遡
泥	坭
泪	淚
洒	灑
洞	峒
洤	泉
洩	泄
洿	汙
浚	濬
浣	澣
浼	凂
涅	湼
涌	湧
涎	㳄
涕	䶏
涖	莅
涶	唾
涼	凉
淆	殽
淒	凄
淚	泪
淜	漰
淡	澹
淨	凈
淫	婬
淳	湻
淹	渰
渚	陼
減	减
渨	隈
温	溫
渫	泄
渰	淹
渹	𢕐
湊	凑
湏	須
湧	涌
湻	淳
湼	涅
溉	摡
準	准
溫	温
溯	遡
溺	氼
溻	褟
溼	濕
溽	縟
滅	烕
滙	匯
滺	悠
漁	䱷
漆	㯃
漇	𢳜
漎	潨
漫	澷
漰	淜
漾	瀁
漿	𤕯
潛	潜
潜	潛
潝	㴔
潣	浼
潨	漎
潬	灘
澀	澁
澁	澀
澈	徹
澗	磵
澣	浣
澳	襖
澷	漫
澹	淡
濇	澀
濕	溼
濛	霥
濬	浚
濱	濵
濵	濱
濶	闊
濿	砅
瀁	漾
瀒	澀
瀕	濱
灑	洒
灘	潬
火	灬
灬	火
灯	燈
灰	灰
灴	烘
灵	靈
灶	竈
災	灾
灾	災
炁	氣
炉	爐
炤	照
炮	砲
炯	烱
炰	炮
炸	煠
点	點
為	爲
烊	煬
烕	滅
烖	災
烘	灴
烛	燭
烜	晅
烝	蒸
烟	完
烱	炯
無	无
焰	燄
煅	鍛
煆	鍜
煇	輝
煑	煮
煖	暖
煙	完
煠	炸
照	炤
煬	烊
煮	煑
煳	㷻
熇	燺
熈	熙
熏	燻
熔	鎔
熙	熈
熨	㷉
熱	𤍠
燄	焰
燈	灯
燐	㷠
燒	簫
燭	烛
燺	熇
燻	熏
燿	曜
爐	炉
爪	㕚
爫	㕚
爭	争
爲	為
爾	尒
爿	𤕪
牀	床
牄	蹌
牆	墻
版	板
牋	箋
牕	窻
牛	牜
牜	牛
牟	麰
牠	他
牴	觝
犁	犂
犂	犁
犇	奔
犬	犭
犭	犬
犲	豺
犴	豻
犹	猶
狥	侚
独	獨
狵	尨
狷	獧
狸	貍
狹	陜
狻	䝜
猇	唬
猋	飇
猗	欹
猨	蝯
猪	豬
猫	貓
猬	蝟
献	獻
猶	犹
猿	猨
獃	呆
獐	麞
獠	䝤
獧	狷
獨	独
獫	玁
獵	𤢪
獻	献
獾	貛
玁	獫
玄	伭
玅	妙
玆	兹
玖	九
玟	玫
玫	玟
玳	瑇
珉	䃉
珍	珎
珎	珍
珪	圭
珷	碔
琄	鞙
琅	瑯
琉	瑠
瑇	玳
瑙	碯
瑠	琉
瑯	琅
璁	𤧚
璃	瓈
璇	璿
璢	琉
璽	壐
璿	璇
瓈	璃
瓟	匏
瓮	罋
瓶	缾
瓷	磁
甎	磚
甕	瓮
甖	罌
甞	嘗
甤	蕤
甦	穌
甬	埇
甯	寗
町	圢
画	畫
甽	畎
甾	菑
甿	氓
畄	留
畆	畝
畊	耕
畎	甽
留	畄
畝	畆
略	畧
畧	略
畫	画
畱	畄
畵	畫
畺	疆
畽	疃
疃	畽
疆	畺
疊	叠
疋	匹
疍	蛋
疎	疏
疏	疎
疣	肬
疱	皰
疴	痾
疸	癉
疹	胗
痐	蚘
痒	癢
痮	脹
痴	癡
痹	痺
痺	痹
痼	㽽
痾	疴
瘂	啞
瘉	癒
瘨	癲
瘶	嗽
瘺	瘻
瘻	瘺
癉	疸
癒	瘉
癡	痴
癢	痒
癯	臞
癲	瘨
登	豋
百	佰
皁	皂
皂	皁
皃	貎
皋	臯
皎	㿟
皓	顥
皜	暠
皝	皓
皞	皡
皡	皞
皥	皞
皦	㿟
皰	疱
皷	鼔
皺	縐
盃	杯
盇	盍
益	益
盌	椀
盍	盇
盖	蓋
盗	盜
盙	簠
盜	盗
盡	尽
盩	盭
盪	蕩
盭	盩
眇	緲
眈	躭
眎	視
眞	真
真	眞
眥	眦
眦	眥
眾	衆
着	著
睏	困
睫	䀹
睹	覩
睾	皋
睿	叡
瞅	矁
瞍	𥈟
瞠	瞪
瞥	苤
瞪	瞠
瞬	䀢
瞯	瞷
瞰	矙
瞷	瞯
瞹	曖
瞿	䀠
矁	瞅
矋	矖
矖	矋
矙	瞰
矧	訠
矮	躷
石	𥐘
砅	濿
砇	珉
砌	纖
砒	磇
研	揅
砠	岨
砣	𥓿
砥	厎
砦	寨
砧	碪
砲	炮
硜	䃘
硤	唊
硭	𥐞
碁	棊
碍	㝵
碔	珷
碗	椀
碪	砧
碯	瑙
碰	掽
碱	鹼
磁	瓷
磇	砒
磊	磥
磌	𧰊
磒	隕
磚	甎
磛	嶃
磡	墈
磥	磊
磪	崔
磴	嶝
磵	澗
磽	墝
礙	㝵
礟	礮
礦	鑛
礮	炮
礱	𤮨
礶	罐
示	礻
礻	示
礼	礼
礿	禴
祐	佑
祕	秘
禀	稟
禂	禱
禮	礼
禱	禂
禴	礿
禿	秃
秃	禿
秄	耔
秆	稈
秇	埶
秈	籼
秋	䆋
秌	秋
秏	耗
秐	耘
秔	粳
秕	粃
秘	祕
秸	稭
移	迻
稈	秆
稉	秔
稊	䄺
稘	朞
稚	䕌
稜	棱
稟	禀
稬	糯
稭	秸
稱	偁
稺	稚
稾	稿
稿	槀
穀	糓
穅	糠
穉	稚
穌	甦
穎	頴
穤	糯
穩	㒚
穪	偁
穫	檴
穽	阱
窃	竊
窌	窖
窓	䆫
窖	窌
窗	䆫
窮	竆
窯	窰
窰	窯
窴	塡
窶	寠
窻	牕
竆	窮
竈	灶
竉	䆔
竊	窃
竒	奇
竚	佇
竝	並
竢	俟
竪	豎
競	誩
竻	簕
竿	𣔼
笋	筍
笑	咲
笓	篦
笔	筆
笛	篴
笨	㤒
筆	笔
筍	笋
筏	栰
答	荅
筦	管
筭	算
筯	箸
筱	篠
箇	个
箋	牋
箍	箛
箎	篪
箒	帚
箖	籃
算	筭
箛	箍
箠	捶
管	筦
箴	針
箸	筯
箾	簫
篋	匧
篠	筱
篡	簒
篢	槓
篦	笓
篩	簛
篪	箎
篴	笛
篺	棑
簁	篩
簌	雝
簒	篡
簕	竻
簛	篩
簠	盙
簡	耕
簣	蕢
簨	栒
簫	燒
簷	檐
簻	檛
簾	𢅖
籃	箖
籄	簣
籐	藤
籑	䉵
籥	龠
籲	龥
籼	秈
粃	秕
粗	麤
粘	黏
粤	粵
粦	㷠
粧	妝
粮	糧
粳	秔
粵	粤
粽	糉
糇	餱
糉	粽
糓	穀
糕	餻
糖	餹
糙	㿷
糟	醩
糠	穅
糡	糨
糤	饊
糧	粮
糨	糡
糯	稬
糰	䊜
糶	條
糸	糹
糹	糸
糺	糾
糾	糺
紙	帋
級	𨸚
紟	衿
紥	紮
紬	綢
紮	扎
紲	緤
紹	佋
絃	弦
絅	褧
絖	纊
絚	緪
絛	縚
絝	袴
絥	鞴
絪	氤
統	綂
綂	統
綉	繡
綑	捆
經	𦀇
綠	氯
綢	紬
綫	線
綳	繃
綻	䘺
綿	緜
緊	𦂳
線	綫
緜	綿
緣	縁
緤	紲
緥	褓
緪	絚
緲	眇
縁	緣
縆	絚
縐	皺
縚	絛
縟	溽
縭	褵
縯	䌥
總	搃
繃	綳
繅	繰
繈	繦
繖	傘
繞	遶
繡	綉
繦	繈
繩	䋲
繮	韁
繰	繅
繲	挫
纊	絖
纎	纖
纖	砌
纜	䌫
缶	缻
缸	堈
缻	缶
缽	鉢
缾	瓶
罁	堈
罃	甖
罅	𨻲
罇	墫
罈	墰
罋	瓮
罌	甖
罐	礶
网	㓁
罔	网
罗	羅
罩	䈇
罪	辠
置	寘
罵	傌
羃	冪
羅	罗
羈	覊
羌	羗
美	羙
羓	豝
羖	𦍩
羗	羌
羙	美
羡	羨
羣	群
群	羣
羨	羡
義	义
羮	羹
羴	羶
羶	羴
羹	羮
翄	翅
翅	翄
翥	䬡
翦	剪
翱	翺
翺	翱
耀	曜
考	攷
耏	耐
耐	耏
耑	專
耔	秄
耕	畊
耗	秏
耘	秐
耙	鈀
耤	藉
耨	鎒
耰	櫌
耻	恥
耼	聃
聃	耼
聖	圣
聝	馘
聦	聰
聰	聦
聲	声
職	軄
聻	魙
聽	听
肆	四
肇	肈
肈	肇
肐	胳
肕	韌
股	𦙶
肢	胑
肧	胚
肨	胮
肬	疣
肱	厷
育	毓
肳	吻
肴	餚
胄	伷
胆	膽
胑	肢
胓	𦚓
胔	骴
胗	疹
胚	肧
胭	臙
胮	肨
胯	骻
胳	肐
胷	匈
胸	匈
脃	脆
脅	脇
脆	脃
脇	脅
脈	衇
脉	䘑
脚	腳
脣	唇
脪	㾙
脹	痮
腊	臈
腕	𦙵
腢	髃
腦	匘
腫	尰
腭	齶
腮	顋
腳	脚
腿	骽
膆	嗉
膋	膫
膫	膋
膳	饍
膽	胆
膾	鱠
臇	𤎱
臈	腊
臊	𦞣
臏	髕
臘	腊
臙	胭
臞	癯
臥	卧
臯	皋
臺	台
舀	抌
與	与
興	㒷
舉	㪯
舊	旧
舐	舓
舓	舐
舔	餂
舖	鋪
舘	館
舡	船
舦	艜
舵	柁
船	舡
艜	舦
艢	檣
艥	楫
艪	樐
艶	豓
艸	草
艹	艸
芒	杧
芔	卉
芟	𠚹
芦	蘆
花	蘤
芻	蒭
苕	䒒
苟	茍
苡	苢
苢	苡
苤	瞥
苺	莓
茍	苟
茠	薅
茲	兹
荅	答
荆	荊
荇	莕
草	艸
荊	荆
荍	蕎
荐	薦
荔	栛
荣	榮
荳	豆
莀	農
莅	涖
莊	庄
莓	苺
莕	荇
莜	蓧
莿	朿
菇	菰
菌	蕈
菑	災
菓	果
菔	蔔
菢	勽
菫	堇
菰	菇
菴	庵
菸	烟
萆	蓖
萬	万
萱	萲
萲	萱
葁	薑
著	着
葚	椹
葢	盖
葬	塟
葯	藥
葱	蔥
蒓	蓴
蒞	涖
蒭	芻
蒸	烝
蓋	盖
蓖	萆
蓧	莜
蓴	蒓
蓺	埶
蔔	菔
蔚	嶎
蔥	葱
蔭	廕
蔴	麻
蕈	菌
蕊	蕋
蕋	蕊
蕎	荍
蕢	簣
蕣	橓
蕤	甤
蕩	偒
薅	茠
薑	葁
薟	蘞
薦	荐
薯	藷
藇	𨣦
藉	耤
藝	埶
藟	蘽
藤	籐
藥	葯
藦	蘑
藷	薯
蘆	芦
蘑	藦
蘖	櫱
蘞	薟
蘤	花
蘯	盪
蘽	藟
虐	䖈
虓	唬
虔	䖍
處	䖏
虜	擄
虞	𩦢
號	号
虣	暴
虫	蟲
虬	蚪
虯	虬
虱	蝨
蚊	蟁
蚋	蜹
蚓	螾
蚕	蠶
蚘	痐
蚝	螆
蚤	䖣
蚦	蚺
蚪	虬
蚺	蚦
蛄	蛌
蛆	𧐅
蛋	蜑
蛌	蛄
蛓	螆
蛔	蚘
蛕	蚘
蛗	𧌓
蛙	鼃
蛛	鼄
蜂	蠭
蜇	𧋍
蜋	螂
蜍	蠩
蜑	蛋
蜝	蜞
蜞	蜝
蜡	䄍
蜨	蝶
蜫	䖵
蜶	蟀
蜹	蚋
蝃	螮
蝇	蠅
蝎	蠍
蝟	猬
蝥	蟊
蝦	鰕
蝨	虱
蝯	猨
蝱	䖟
蝶	蜨
螂	蜋
螆	蚝
融	螎
螎	融
螗	螳
螘	蟻
螙	蠧
螮	蝃
螳	螗
螺	蠃
螾	蚓
蟀	蜶
蟁	蚊
蟊	蝥
蟚	蟛
蟛	蟚
蟮	蟺
蟲	虫
蟹	蠏
蟺	蟮
蟻	螘
蠃	螺
蠅	蝇
蠍	蝎
蠏	蟹
蠔	𧐢
蠟	蜡
蠧	螙
蠩	蜍
蠭	蜂
蠶	蚕
衂	衄
衄	衂
衅	釁
衆	眾
衇	脈
衛	衞
衝	𧘂
衞	衛
衣	衤
衤	衣
衮	袞
衽	袵
衿	紟
袋	帒
袒	襢
袜	襪
袞	衮
袠	帙
袴	絝
袵	衽
袷	裌
裉	褃
裌	袷
裏	裡
裙	帬
裠	裙
裡	裏
裸	躶
褃	裉
褎	褏
褏	褎
褒	襃
褓	緥
褟	溻
褢	褱
褧	絅
褱	褢
褲	絝
褵	縭
褺	䙝
褻	䙝
襁	繈
襃	褒
襄	㐮
襍	雜
襖	澳
襜	襝
襝	襜
襟	衿
襢	袒
襪	袜
襮	幞
襯	儭
覇	霸
覊	羈
覌	觀
覐	覺
覓	覔
覔	覓
視	眎
覘	䦓
覥	靦
覩	睹
覰	覷
覷	覰
覺	覐
觀	覌
觔	斤
觕	粗
觜	咀
觝	牴
解	觧
觥	觵
觧	解
觵	觥
訇	渹
託	侂
訛	譌
訠	矧
訥	吶
訦	諶
訩	詾
訴	愬
証	證
訽	詬
詋	呪
詠	咏
詤	謊
詧	察
詬	訽
話	䛡
詵	侁
詾	訩
誇	夸
誐	哦
誕	𧩙
誘	䛻
誚	譙
誤	悞
誩	競
諁	啜
談	譚
諉	餵
諊	鞫
諕	唬
諠	喧
諡	謚
諤	讍
諧	龤
諮	咨
諵	喃
諶	訦
謊	詤
謌	歌
謚	諡
謫	讁
謱	嘍
譁	嘩
譈	憝
證	証
譌	訛
譎	憰
譐	噂
譙	誚
譚	談
譟	噪
警	儆
譭	䛼
讁	謫
變	变
讌	宴
讍	諤
讎	仇
讐	仇
讘	囁
谿	嵠
豆	荳
豇	䜶
豋	登
豎	竪
豓	艶
豔	艶
豘	豚
豚	豘
豜	豣
豝	羓
豣	豜
豫	預
豬	猪
豳	㟗
豴	蹢
豵	䝋
豸	廌
豺	犲
豻	犴
貌	皃
貍	狸
貎	皃
貓	猫
貛	獾
財	㒲
販	𧶶
貭	質
貳	二
賅	侅
賍	贓
賓	賔
賔	賓
賛	贊
賢	贒
質	貭
賫	齎
賬	帳
賮	贐
賴	頼
賸	剩
賺	贃
贃	賺
贊	賛
贋	偐
贐	賮
贒	賢
贓	賍
贗	偐
贜	賍
赤	𤆍
赬	䞓
赶	趕
趁	趂
趂	趁
趄	跙
趋	趨
趒	跳
趕	赶
趨	趋
趮	躁
趯	躍
跖	蹠
跙	趄
跡	蹟
跥	跺
跳	趒
跴	踹
跺	跥
踁	硜
踊	踴
踏	蹋
踪	蹤
踭	㬹
踰	逾
踴	踊
踵	歱
踹	跴
踽	偊
蹄	蹏
蹋	踏
蹌	牄
蹏	蹄
蹝	屣
蹟	跡
蹠	跖
蹢	豴
蹤	踪
蹧	遭
蹮	躚
蹴	蹵
蹵	蹴
蹹	蹋
蹺	蹻
蹻	蹺
躁	趮
躅	䠱
躋	隮
躍	趯
躗	躛
躚	蹮
躛	躗
躧	屣
躬	躳
躭	眈
躱	躲
躲	躱
躳	躬
躶	裸
躷	矮
軄	職
軆	体
軟	輭
軰	輩
軺	𨍳
輒	輙
輙	輒
輝	煇
輩	軰
輭	軟
輵	轕
輿	轝
轄	鎋
轆	樚
轕	輵
轗	㙳
轝	輿
辞	辤
辠	罪
辢	辣
辣	辢
辤	辞
辦	办
辨	辯
辭	辞
辯	辨
農	莀
辵	辶
辶	辵
边	邊
迁	遷
过	過
迊	匝
迕	忤
还	還
这	這
迨	逮
迩	邇
迪	廸
迫	廹
迯	逃
迴	廻
迹	跡
迺	乃
迻	移
逃	迯
逓	遞
逖	逷
這	这
逮	迨
週	周
逷	逖
逼	偪
逾	踰
遍	徧
過	过
遜	愻
遞	逓
遡	泝
遭	蹧
遶	繞
遷	迁
還	还
邅	㣶
邇	迩
邊	边
邕	雍
邠	㟗
邨	村
郁	喐
郄	郤
郤	郄
郰	鄹
郷	鄉
鄉	郷
鄔	塢
鄕	鄉
鄰	隣
鄹	郰
酖	鴆
酧	酬
酬	酧
醇	䣩
醊	餟
醡	榨
醩	糟
醫	医
醻	酧
釁	衅
野	埜
釐	厘
金	釒
釒	金
針	箴
釬	銲
鈀	耙
鈆	鉛
鈎	鉤
鈞	銁
鉄	鐵
鉆	鉗
鉈	砣
鉋	刨
鉏	鋤
鉗	鉆
鉛	鈆
鉞	戉
鉢	缽
鉤	鈎
銁	鈞
銕	鉄
銜	㘅
銲	釬
銹	鏽
鋑	鐫
鋤	鉏
鋪	舖
錘	鎚
鍉	匙
鍛	煅
鍜	煆
鍫	鍬
鍬	鍫
鍰	鐶
鍼	箴
鎋	轄
鎌	鐮
鎏	鏐
鎒	耨
鎔	熔
鎖	鏁
鎙	槊
鎚	錘
鎻	鎖
鏁	鎖
鏐	鎏
鏢	鑣
鏥	銹
鏰	斆
鏽	銹
鏾	𠜎
鐀	匱
鐫	鋑
鐮	鎌
鐵	鉄
鐶	鍰
鑑	鑒
鑒	鑑
鑚	鑽
鑛	礦
鑢	䥨
鑣	鏢
鑴	鋑
鑽	鉆
門	门
閆	閻
閙	鬧
関	闗
閧	鬨
閹	剦
閻	閆
闊	濶
闗	関
關	寡
门	門
阜	阝
阝	阜
阡	仟
阧	陡
阨	阸
阬	坑
阱	穽
阳	氜
阴	陰
阸	阨
陀	陁
陁	陀
降	夅
陗	峭
陜	狹
陡	阧
陣	𨸬
陰	阴
陶	匋
陻	垔
陼	渚
陽	氜
隂	陰
隄	堤
隈	渨
隍	堭
階	堦
隐	隠
隕	磒
隖	塢
隝	塢
隠	隐
隣	鄰
隤	墤
隧	𡑞
隩	𡒃
隮	躋
隱	乚
隲	騭
隷	隸
隸	隷
隼	鶽
隽	雋
难	難
雁	鴈
集	亼
雇	僱
雋	隽
雍	邕
雕	㓮
雙	双
雛	鶵
雜	襍
雝	簌
雞	鷄
難	难
雱	霶
霜	孀
霡	霢
霢	霡
霥	濛
霰	䨘
霶	雱
霸	覇
靀	濛
靈	灵
靝	天
靦	覥
靧	頮
靭	韌
靴	鞾
鞀	鼗
鞉	鞀
鞋	鞵
鞘	韒
鞙	琄
鞟	鞹
鞦	鞧
鞧	鞦
鞫	諊
鞲	韝
鞴	絥
鞵	鞋
鞹	鞟
鞽	橇
鞾	靴
韁	繮
韂	䩞
韈	襪
韌	肕
韒	鞘
韜	弢
韝	鞲
韤	襪
韭	韮
韮	韭
韵	韻
韻	韵
響	响
頂	𩠑
須	湏
頋	顧
預	豫
頟	額
頣	頤
頤	頣
頫	俯
頮	靧
頴	穎
頼	賴
顋	腮
額	頟
顕	顯
顖	囟
願	愿
類	𩔗
顥	皓
顦	憔
顧	頋
顯	顕
顰	嚬
顱	髗
颮	猋
颼	䬒
飇	猋
食	飠
飠	食
飡	餐
飢	饑
飤	飼
飦	饘
飪	䏕
飫	饇
飼	飤
飾	餙
餂	舔
餅	餠
餉	饟
餐	飡
餒	餧
餙	飾
餚	肴
餛	餫
餜	䴹
餟	醊
餠	餅
餧	喂
館	舘
餫	餛
餱	糇
餵	諉
餹	糖
餻	糕
餽	饋
饇	飫
饈	𦟤
饊	糤
饋	匱
饌	䉵
饍	膳
饑	飢
饕	叨
饘	飦
饞	嚵
饟	餉
馘	聝
馚	馩
馩	馚
馭	御
馱	䭾
馿	驢
駁	駮
駛	𩢲
駢	騈
駦	騰
駪	侁
駮	駁
騈	駢
騌	騣
騐	驗
騗	騙
騘	驄
騙	騗
騣	騌
騭	隲
騰	駦
騾	驘
驄	騘
驅	敺
驊	𦽊
驗	騐
驘	騾
驢	馿
骴	胔
骻	胯
骽	腿
骾	挭
髃	腢
體	体
髕	臏
髗	顱
高	髙
髙	高
髣	彷
髻	䯻
髼	鬅
鬀	剃
鬂	鬢
鬅	髼
鬒	㐱
鬓	𩯭
鬢	鬂
鬣	巤
鬥	鬭
鬦	鬥
鬧	閙
鬨	閧
鬪	鬥
鬬	鬥
鬭	鬥
鬮	䰗
鬱	欝
魏	巍
魙	聻
魟	鰩
魦	鯊
魷	鰌
鮝	鯗
鮧	鯷
鮮	鱻
鯁	挭
鯊	魦
鯗	鮝
鯧	䱽
鯷	鮧
鰉	鱑
鰌	魷
鰍	鰌
鰐	鱷
鰕	蝦
鰩	魟
鰲	鼇
鱉	鼈
鱑	鰉
鱓	䱇
鱔	鱓
鱠	膾
鱷	鰐
鱻	鮮
鳮	雞
鴃	鵙
鴆	酖
鴈	雁
鴝	朐
鴞	梟
鴳	鷃
鴺	鵜
鵙	鴃
鵜	鴺
鵝	鵞
鵞	鵝
鵻	隼
鶂	鶃
鶃	鶂
鶯	鸎
鶵	雛
鶽	隼
鷃	鴳
鷄	雞
鷩	氅
鸎	鶯
鸜	朐
鹻	堿
鹼	堿
鹽	䀋
麄	粗
麇	麕
麐	麟
麕	麇
麞	獐
麟	麐
麤	粗
麪	麵
麫	麵
麯	麴
麰	牟
麴	麯
麵	麪
麻	蔴
麼	庅
麽	庅
黏	粘
默	嘿
黙	默
點	点
鼃	蛙
鼄	蛛
鼇	鰲
鼈	鱉
鼎	𪔂
鼏	冪
鼓	皷
鼔	皷
鼗	鞀
齁	𪖙
齅	嗅
齊	亝
齋	斋
齎	賫
齦	啃
齧	囓
齩	咬
齶	腭
龍	龒
龎	龐
龐	龎
龒	龍
龓	䪊
龝	秋
龠	籥
龡	吹
龢	咊
龤	諧
龥	籲
鿌	涼
益	益
礼	礼
𠂝	眾
𠂤	𣳨
𠆌	庸
𠊧	併
𠔃	兮
𠕄	凹
𠖥	寵
𠗦	憑
𠚹	芟
𠜎	鏾
𠜼	掐
𠞰	剿
𠦌	卌
𠭴	㑁
𠯗	咂
𠱓	𠼮
𠱘	𠸺
𠲿	欶
𠸺	𠱘
𠼮	𠱓
𡅈	嚹
𡈙	囮
𡑞	隧
𡒃	隩
𡚁	弊
𡜱	嫉
𡞾	嫩
𡨴	寧
𡱆	属
𡲕	屜
𡻕	亗
𢂑	拭
𢅏	㡘
𢅖	簾
𢆞	䄯
𢊍	㕑
𢍺	弋
𢐧	檠
𢕐	渹
𢙢	恐
𢙱	㑝
𢜫	惺
𢠳	憋
𢠵	惝
𢥠	悚
𢭆	抽
𢯱	搜
𢰾	摠
𢲷	搜
𢳆	摮
𢳜	漇
𢶑	𢸣
𢶣	㩹
𢸣	𢶑
𣁚	𣁟
𣁟	𣁚
𣄈	㫎
𣇀	晡
𣉞	暠
𣓌	槹
𣔼	竿
𣳨	𠂤
𤆍	赤
𤍠	熱
𤎱	臇
𤑕	熏
𤕪	爿
𤕭	将
𤕯	漿
𤢕	斁
𤢪	獵
𤧚	璁
𤮨	礱
𥁕	昷
𥂁	鹽
𥅾	䚎
𥈟	瞍
𥋟	䂀
𥐘	石
𥐞	硭
𥓿	砣
𥔀	渹
𥜌	澳
𥝢	利
𥥅	竉
𥫱	囤
𥵚	竻
𥻟	糯
𦀇	經
𦂳	緊
𦍩	羖
𦕒	䦓
𦙵	腕
𦙶	股
𦙼	骴
𦚓	胓
𦞣	臊
𦟤	饈
𦢌	殰
𦤎	臯
𦱄	菇
𦲷	蒞
𦷝	芻
𦽊	驊
𧋍	蜇
𧌓	蛗
𧐅	蛆
𧐢	蠔
𧘂	衝
𧙀	𧞪
𧞪	𧙀
𧩙	誕
𧬨	噦
𧰊	磌
𧴯	孭
𧶶	販
𧸖	贃
𧿹	拇
𨃞	𨃟
𨃟	𨃞
𨈚	𨉉
𨉉	𨈚
𨍳	軺
𨑒	徒
𨢥	䤍
𨣦	藇
𨶹	関
𨸚	級
𨸬	陣
𨻲	罅
𩋘	鞋
𩔗	類
𩠑	頂
𩢲	駛
𩦢	虞
𩨘	肐
𩯭	鬓
𪔂	鼎
𪖙	齁
𪪝	邕
冗	冗
灰	灰
冒	冒
